+--+--+--+--+--+--+--+--+--+--+
|     |        |     |        |
+  +  +  +--+  +  +  +  +--+  +
|  |     |        |  |     |  |
+  +--+--+  +--+  +  +--+  +  +
|     |     |     |     |     |
+--+  +  +  +--+  +--+  +  +--+
|     |  |        |     |     |
+  +--+  +--+  +--+  +--+  +  +
|  |     |     |     |     |  |
+  +--+  +  +  +  +  +  +  +  +
|        |  |  |  |     |     |
+--+--+  +  +  +  +  +  +--+--+
|        |  |  |     |        |
+  +--+--+  +  +--+--+  +  +  +
|  |     |  |     |     |  |  |
+  +  +  +  +--+  +--+  +  +  +
|     |     |     |     |     |
+  +  +--+--+  +--+--+--+--+  +
|  |                          |
+--+--+--+--+--+--+--+--+--+--+
