###################################
#                                 #
#  #####    #####     #####       #
#  #   #              #   #       #
#  # # ##### # # ####### #######  #
#    #     #   #     #         #  #
#  ####### # ######### ####### #  #
#  #       #       #       #   #  #
#  #  ###########  #####   ### #  #
#     #       #                   #
#  ######### ######### #########  #
#  #       # #     #       #      #
#  #  # #  # # ### #####   #  ##  #
#     # #    # #     #     #   #  #
#  ##### ##### ####### ##### ###  #
#  #               #       #   #  #
#  # ############# # ####### #### #
#                  #              #
###################################
