################
#              #
# +++++    ### #
# +   +    # # #
# + # +      # #
# + # +++++  # #
# +        +++ #
# +++++ ++   + #
#     # ++   + #
# ### # ++   + #
# #   #      + #
# # ##### ++++ #
#   #     +    #
# ### ###+#### #
#              #
################