+--+--+--+--+--+--+--+--+--+--+
|                    |        |
+  +--+--+  +--+--+  +  +--+  +
|        |        |     |     |
+  +--+--+  +--+  +--+--+  +--+
|  |     |     |  |     |     |
+  +  +  +--+  +  +--+  +--+  +
|  |  |     |  |     |     |  |
+--+  +--+  +--+--+  +--+  +  +
|     |     |     |     |  |  |
+  +--+  +--+  +  +--+  +  +  +
|  |           |        |  |  |
+  +--+--+--+  +--+--+--+  +  +
|        |     |     |     |  |
+--+--+  +--+--+  +  +  +--+  +
|        |        |  |        |
+  +--+  +--+--+--+  +--+  +--+
|     |     |     |     |     |
+  +  +--+--+  +  +--+  +--+  +
|  |           |        |     |
+--+--+--+--+--+--+--+--+--+--+