+--+--+--+--+--+--+--+--+--+--+
|        |           |        |
+--+  +  +--+  +--+  +  +--+  +
|     |     |  |     |     |  |
+  +--+  +  +  +  +--+  +  +  +
|     |  |  |  |  |     |     |
+  +  +  +  +  +  +  +--+--+  +
|  |     |     |     |     |  |
+  +  +--+--+  +--+  +  +  +  +
|     |        |     |  |     |
+  +  +  +--+  +  +--+  +--+  +
|  |     |     |     |        |
+  +--+  +  +--+  +--+--+--+  +
|     |  |     |           |  |
+  +  +  +  +--+  +--+--+  +  +
|  |     |        |     |     |
+  +--+--+--+--+--+  +  +--+  +
|                    |        |
+--+--+--+--+--+--+--+--+--+--+
