+--+--+--+--+--+--+--+--+--+--+
|     |        |     |        |
+  +  +  +--+  +  +  +  +--+  +
|  |     |     |  |  |     |  |
+  +--+--+  +--+  +  +--+  +  +
|     |     |     |     |     |
+--+  +  +  +--+--+--+  +  +--+
|     |  |        |     |     |
+  +--+  +--+  +--+  +--+  +  +
|  |     |     |     |     |  |
+  +--+  +  +  +  +  +  +  +  +
|        |  |  |  |  |  |     |
+--+--+  +  +  +  +  +  +--+--+
|        |  |  |     |        |
+  +--+--+  +  +--+--+  +  +  +
|  |     |  |     |     |  |  |
+  +  +  +  +--+  +--+  +  +  +
|     |     |     |     |     |
+  +  +--+--+  +--+--+--+--+  +
|  |                          |
+--+--+--+--+--+--+--+--+--+--+
