+--+--+--+--+--+--+--+--+--+--+
|                    | A      |
+  +--+--+  +--+--+  +  +--+  +
|  A     |        |     |     |
+  +--+--+  +--+  +--+--+  +--+
|  |     | A   |  |     | A   |
+  +  +  +--+  +  +--+  +--+  +
|  |  |     |  | A   |     |A |
+--+  +--+  +--+--+  +--+  +  +
|   A |     |     |     |  |  |
+  +--+  +--+  +  +--+A +  +  +
|  |           |        |  |  |
+  +--+--+--+  +--+--+--+  +  +
| A      |   A |     |  A  |  |
+--+--+  +--+--+  +  +  +--+  +
|  A     |O       |  |        |
+  +--+  +--+--+--+  +--+  +--+
|  A  |     |     |     |  A  |
+  +  +--+--+  +  +--+  +--+  +
|  |           | A      |     |
+--+--+--+--+--+--+--+--+--+--+